111111111111
111100101111
110000100011
1110001p0011
100000111111
100030130011
102020100011
100300103001
100000100211
100000000011
100001030311
111111111111