111111111111
141101400011
100104400301
101111111001
110010000401
110010004211
100111004001
110011230001
101000000001
111100p04001
101104000001
111111111111