101111111111
101000000001
101000000001
101110000001
100000000001
111110000001
100000000001
100000000001
100000000000
100111000000
100000000001
111111111111