111111111111
1p1000000001
101000000001
101110000111
100000000101
111110000101
100000000101
102000000101
100000002100
100111001100
102000000201
111111111111