111111111111
1p1000000001
101000000001
101110000111
100000010101
111110010101
100000010101
102011110101
100000002100
100111001100
102000000201
111111111111