111111111111
1p1000000001
101000000001
101110000001
100000000001
111110000001
100000000001
102000000001
100000002000
100111000000
102000000201
111111111111