111111111111
1p0000000001
101000000001
101110000111
100000010101
111111010101
100300010101
102011110101
100001402100
100111001100
102003000201
111111111111