000010000000
000000010000
000220100110
000300000011
200000013011
000300021100
011200301000
011001100002
111211110000
011000001111
01111010p000
211100000000