111111111111
100001000001
1000010000p1
102000001111
100000100001
100001010101
100001010101
102001000101
100000002101
100000000001
100000000001
111111111111