111111111111
100000000001
100000000001
102000000111
100000000101
100001010101
100001010101
102001110101
100000002101
100000000001
10p000000001
111111111111