COLORDATA
111111111111
100100000001
100100020001
100201110001
100001000001
111002000001
100000000001
100011110001
100010000201
10001p000001
100011000001
111111111111